1111111111111111111
1P00C10000000000C11
1011110011000111111
10C00000010000E0001
1111111111111111111