1111111111111111111
1P00C10P0000P000C11
1011110011000111111
10C0000P010000E0001
1111111111111111111