1111111111111111111
1C100000000000000C1
1010001000000000001
100000100P000000001
10000010111000000C1
10000010E11000000E1
1111111111111111111